10
..#E#..###
.##.#.#...
......#.#.
#####.##..
...#...#.#
.#.#.###.#
.#.#...##.
##.###.##.
.#.....##.
.#.##.#...
