20
####################
#.............#.....
#.###.#######.###.#.
#...#...#...#.....#.
###.###.#.#.#######.
#.....#.#.#.#.......
#.#####.#.#.########
#...#...#.#.........
###.#.#.#.#########.
#...#.#.#.#...#...#.
#####.#####.#.#.#.#.
#.....#.....#.#.#...
#.#.###.###.###.####
#.#.#.....#...#.#...
#.###.#######.#.###.
#...#.#.#.....#.....
###.#.#.#.#########.
#.....#.#.#...#.....
#.#####.#.#.#.#.####
#.......#...#..E....
