20
####################
#.#.....#...#.....#.
#.#.###.#.###.###.#.
#...#...#...#.#...#.
#.###.#####.#.#.###.
#.#...#.....#.#.....
#.###.#.#.###.######
#...#.#.#.#...#.....
###.#.#.#.#.###.###.
#...#...#.#...#.#...
###.#####.###.#.#.##
#...#...#.#.#.#.#...
#.###.#.#.#.#.#.###.
#.#...#.....#.#.#...
#.###########.#.#.##
#.....#.....#...#...
#####.#.###.#######.
#.#.......#.#.......
#.#.#####.#.#.######
#...E.....#.........
