15
##########E####
#...#.........#
#.#.#.#####.###
#.#.#.#...#...#
#.###.#.#.#####
#.#...#.#.....#
#.#.#####.#.###
#...#...#.#...#
#.###.#.#.###.#
#.#...#.#.#...#
#.#.#.#.###.###
#.#.#.#...#...#
#.###.###.#.#.#
#.....#.....#.#
###############
