15
###############
#...#.........#
#.#.#.#######.#
#.#...#.....#.#
#.#####.#.#.#.#
#...#...#.#.#.#
#.#.#.###.#.###
#.#.#...#.#...#
#...###.#.###.#
#.#.....#.#...#
#.###.###.#####
#...#...#.....#
###.###.#####.#
#...#.....#...#
######E########
